az óceánban nyüzsög az élet | az óceán nyüzsög az élet | Article Noun Verb Article Noun 
a szivacs az egyetlen mozgásképtelen állat | a szivacs az le képtelen állat | Article Noun Article Adverb Adjective Noun 
a tudás hatalom | a tudás hatalom | Article Noun Noun 
az eufória pezsdítő érzése járta át | az eufória N\A érzés jár át | Article Noun N\A Noun Verb Adverb 
a geometria a matematikai forma tudománya | a geometria a matematikai forma tudomány | Article Noun Article Adjective Noun Noun 
mindenféle emberi tevékenységet megvizsgáltak | mind emberi tevékenység megvizsgál | Number Adjective Noun Verb 
gond volt a csoportban a kommunikációval | gond volt a csoport a kommunikáció | Noun Adjective Article Noun Article Noun 
hogyan művelhettél ilyen csúnya dolgot | hogyan művel l csúnya l | Adverb Verb Noun Adjective Noun 
cselekedetei híven tükrözték gondolatait | cselekedet híve tükröz gondolat | Noun Noun Verb Noun 
napi kapcsolatban álltak egymással | nap kapcsolat áll más | Noun Noun Noun Adjective 
a cég állásközvetítéssel is foglalkozik | a cég állásközvetítés N\A foglalkozik | Article Noun Noun N\A Verb 
értett a kardforgatáshoz | tett a kardforgatás | Noun Article Noun 
a közúti baleset okozása gondatlan bűncselekmény | a köz baleset okozás gondatlan bűncselekmény | Article Noun Noun Noun Adjective Noun 
amerika felfedezése jelentette az újkor kezdetét | erika felfedezés jelent az kor kezdet | Noun Noun Verb Article Noun Noun 
izgatottan vártuk az érkezését | izgatottan vár az érkezés | Adverb Noun Article Noun 
már régóta vártuk visszatérését hamlet szerepében | mar ego vár visszatérés ml szerep | Verb Noun Noun Noun Noun Noun 
hazaérkezése alkalmából vacsorát rendeztünk nekik | hazaérkezés alka vacsora rendez ki | Noun Noun Noun Verb Adverb 
megdöntötte a világcsúcsot | dönt a világcsúcs | Verb Article Noun 
váratlan sikert ért el mindkét versenyszámban | váratlan siker ért el mind verseny | Adjective Noun Verb Adverb Number Noun 
nagy hibát követett el | nagy hiba követ el | Adjective Noun Noun Adverb 
ekkora tapintatlanságot még sosem láttam | kora tapintatlanság még sose lát | Noun Noun Adverb Adverb Verb 
a vételt kézszorítással pecsételték meg | a vétel kézszorítás ecsetel m | Article Noun Noun Verb Noun 
az anyagbeszerzés sok jövés-menéssel jár | az anyagbeszerzés ok menés jár | Article Noun Noun Noun Verb 
gyakori a videokazetta csempészet ázsiában | gyakori a kazetta csempészet ban | Adjective Article Noun Noun Noun 
a megváltás a keresztény hit alaptétele | a megváltás a keresztény hit tétel | Article Noun Article Noun Noun Noun 
háromheti vezeklésre ítélték | rom vezeklés telt | Noun Noun Adjective 
sok kritikával illették polgármesteri teljesítményét | ok kritika lett polgármester teljesítmény | Noun Noun Noun Noun Noun 
egy gurításból leütötte az összes bábut | egy gurítás leüt az N\A bábu | Article Noun Verb Article N\A Noun 
a székek húzásától megsérült a parketta | a szék húzás sérült a parkett | Article Noun Noun Adjective Article Noun 
egy böffenéssel zárta a mondókáját | egy böffenés zárt a mond | Article Noun Adjective Article Verb 
a lőfegyverrel való lövést szakértők oktatják | a lőfegyver való lövés szakértő oktat | Article Noun Noun Noun Noun Verb 
az ütközéskor megsérült a háta | az ütközés sérült a hat | Article Noun Adjective Article Verb 
csókkal váltak el egymástól | sokkal vált el tol | Adverb Verb Adverb Verb 
orvosa elküldte egy teljes kivizsgálásra | orvos elküld egy teljes kivizsgálás | Noun Verb Article Adjective Noun 
újabb kontrollvizsgálatra rendelték be a kórházba | új kontrollvizsgálat rendel be a kórház | Adjective Noun Verb Adverb Article Noun 
ki nem állhatta a csiklandozást | ki nem hat a csiklandozás | Adverb Noun Verb Article Noun 
a fordulat éve | a fordulat eve | Article Noun Noun 
megkapta a kinevezését | megkap a kinevezés | Verb Article Noun 
a példa a meggyőzés legjobb eszköze | a példa a meggyőzés legjobb eszköz | Article Noun Article Noun Adjective Noun 
a törvény szava | a törvény N\A | Article Noun N\A 
a nép hangja | a nép hang | Article Noun Noun 
*its adoption by society | N\A ion N\A N\A | N\A Noun N\A N\A 
*the proposal found wide acceptance | N\A rop un ide tan | N\A Verb Verb Adverb Noun 
két szavazattal nyert a választáson | N\A szavazat nyer a választás | N\A Noun Verb Article Noun 
álláspontjának megváltoztatása választási esélyeit teljesen lecsökkentette | álláspont megváltoztatás választás esély teljesen csökkentett | Noun Noun Noun Noun Adverb Adjective 
a rendbontó katonákat lefokozással fenyegette felettesük | a rend katonák lefokozás fenyeget felettes | Article Noun Noun Noun Verb Noun 
ellenállást tanúsít | ellenállás tanúsít | Noun Verb 
az indítványt elutasították | az indítvány elutasít | Article Noun Verb 
befejezésül elénekelték a himnuszt | befejezés elénekel a himnusz | Noun Verb Article Noun 
főnöke elfogadta a lemondását | főnök elfogad a lemondás | Noun Verb Article Noun 
az ölést tiltja a tízparancsolat | az ölés tilt a parancsolat | Article Noun Verb Article Noun 
az előadás kezdete mindenkit meglepett | az előadás kezdet mind meglep | Article Noun Noun Number Verb 
az új adók bevezetését elhalasztják januárig | az új adó bevezetés elhalaszt január | Article Adjective Noun Noun Verb Noun 
mindig is vonzotta a sütés-főzés világa | mindig N\A vonz a sütés-főzés világ | Adverb N\A Verb Article Noun Noun 
a honlap fejlesztés alatt áll | a honlap fejlesztés l áll | Article Noun Noun Noun Noun 
a kabát tisztítását bízd szakemberre | a kabát tisztítás bíz szakember | Article Noun Noun Verb Noun 
borotválkozás közben megvágta az arcát | borotválkozás köz megvág az arc | Noun Noun Verb Article Noun 
a tusolás után teljesen felfrissültem | a tusolás tan teljesen felfrissül | Article Noun Noun Adverb Verb 
a fa díszítése délutánra maradt | a fa díszítés délután marad | Article Noun Noun Noun Verb 
karbantartás miatt ma zárva tartunk | karbantartás m ma zár tart | Noun Noun Noun Noun Verb 
az áru mozgatására kisméretű targoncákat alkalmaznak | az áru mozgatás ismeret targonca alkalmaz | Article Noun Noun Noun Noun Verb 
jót tesz egy rövid séta | jó tesz egy rövid séta | Adjective Verb Article Adjective Noun 
szégyen a futás de hasznos | szégyen a futás N\A hasznos | Noun Article Noun N\A Adjective 
a repülés fantasztikus élmény volt | a repülés fa élmény volt | Article Noun Noun Noun Adjective 
túl van a századik ejtőernyős ugrásán | túl van a század ejtőernyős ugrás | Adverb Verb Article Noun Noun Noun 
kirándulást szerveztek a pilisbe | kirándulás szervez a be | Noun Verb Article Adverb 
*they are on the way | N\A N\A N\A N\A N\A | N\A N\A N\A N\A N\A 
az idei második űrrepülés sikeresen zajlott | az ide második űrrepülés sikeresen zaj | Article Adverb Noun Noun Adverb Noun 
vad hajszába kezdtek | vad hajsza kezd | Noun Noun Verb 
vérátömlesztést kapott a műtét alatt | vérátömlesztés kap a műtét l | Noun Verb Article Noun Noun 
az állandó lengéstől elkopott az alkatrész | az állandó lengés ott az alkatrész | Article Noun Noun Adverb Article Noun 
látványos csúszásokat mutatott be a jégen | látvány csúszás mutat be a jég | Noun Noun Verb Adverb Article Noun 
nagy sietségben volt | nagy sietség volt | Adjective Noun Adjective 
a gyorsulástól teljesen elszédült | a gyorsulás teljesen szed | Article Noun Adverb Verb 
a folytonos helyváltoztatás szétzilálta az osztályt | a folytonos helyváltoztatás zilált az osztály | Article Adjective Noun Adjective Article Noun 
keze finom mozdulatával jelezte csak jóváhagyását | N\A finom mozdulat jelez csak jóváhagyás | N\A Adjective Noun Verb Adverb Noun 
a gesztikulálás célja egy gondolat hangsúlyozása | a gesztikulálás cél egy gondolat hangsúlyoz | Article Noun Noun Article Noun Verb 
egy csavarással helyére került minden | egy csavarás hely kerül mind | Article Noun Noun Verb Number 
a gyarmatosítók hulláma | a gyarmatos hullám | Article Noun Noun 
az űrhajó irányváltoztatása súlyos következményekkel járna | az űrhajó irányváltoztatás súlyos következmény jár | Article Noun Noun Adjective Noun Verb 
a visszafordulást követően mindenki nyugodtabb lett | a visszafordulás követő mind nyugodt lett | Article Noun Noun Number Adjective Noun 
eltérés az eredeti szándéktól | eltérés az eredeti szándék | Noun Article Adjective Noun 
a tárgyak összetörése nem segít | a tárgy összetörés nem segít | Article Noun Noun Noun Verb 
majdnem elfelejtettem a darálást | majdnem elfelejt a darálás | Adjective Verb Article Noun 
a nedvek kisajtolásához megfelelő présgépet használunk | a N\A kisajtolás megfelelő prés használ | Article N\A Noun Adjective Noun Verb 
a zsákok raktározását az alvállalkozóra bízta | a zsák raktározás az vállalkozó bíz | Article Noun Noun Article Noun Verb 
a petárda robbanása megijesztette a kutyákat | a petárda robbanás megijeszt a kutya | Article Noun Noun Verb Article Noun 
montenegró különválásáról szavaztak a múlt héten | negró különválás szavaz a múlt hét | Noun Noun Verb Article Noun Noun 
az elhalt rész eltávolítása sebészi feladat | az elhal rész eltávolítás sebész feladat | Article Verb Noun Noun Noun Noun 
a szemölcs kimetszésétől már előre félt | a szemölcs kimetszés mar előre félt | Article Noun Noun Verb Adverb Verb 
fárasztó volt a ládák kiürítése | fárasztó volt a ad kiürítés | Adjective Adjective Article Verb Noun 
az elmélettel néha szembenáll a gyakorlat | az elmélet néha szemben a gyakorlat | Article Noun Adverb Adverb Article Noun 
követte a helyi szokásokat | követ a helyi szokás | Noun Article Adjective Noun 
az északi államok ellenezték a rabszolgatartást | az észak állam ellenez a rabszolgatartás | Article Noun Noun Verb Article Noun 
útjaink rövid találkozás után szétváltak | út rövid találkozás tan szétvált | Noun Adjective Noun Noun Adjective 
posh spice kedvenc időtöltése a vásárlás | N\A N\A kedvenc időtöltés a vásárlás | N\A N\A Noun Noun Article Noun 
több sportot is kipróbált | több sport N\A kipróbál | Adjective Noun N\A Verb 
három szaltóra is képes egymás után | rom szaltó N\A képes más tan | Noun Noun N\A Adjective Adjective Noun 
az úszás az egyik legegészségesebb mozgásforma | az úszás az N\A egészséges mozgás | Article Noun Article N\A Adjective Noun 
ökölvívásban nyert olimpiai aranyat | ökölvívás nyer olimpia arany | Noun Verb Noun Noun 
tegnap bokszmeccs volt a tévében | tegnap bokszmeccs volt a teve | Adverb Noun Adjective Article Noun 
a kakasviadal sok országban illegális tevékenység | a kakasviadal ok ország illegális tevékenység | Article Noun Noun Noun Adjective Noun 
a horgászatnak szenteli a hétvégéket | a horgászat szentel a eke | Article Noun Verb Article Noun 
élete csupa játék és szórakozás | élet N\A játék N\A szórakozás | Noun N\A Noun N\A Noun 
a tenpin bowling egyre kedveltebb hazánkban | a N\A bowling N\A kedvelt haza | Article N\A Noun N\A Adjective Noun 
golfban is legyőzte | golf N\A legyőz | Noun N\A Verb 
a krokett felénk nem felkapott sport | a krokett fel nem felkapott sport | Article Noun Adverb Noun Adjective Noun 
már itthon is létezik amerika futball | mar itthon N\A létezik erika futball | Verb Adverb N\A Verb Noun Noun 
a softballt még kevesen játszák felénk | a softball még eve át fel | Article Noun Adverb Noun Adverb Adverb 
a lacross elég ismeretlen sport európában | a l elég ismeretlen sport euro | Article Noun Verb Noun Noun Noun 
a foci a világ legnépszerűbb sportága | a foci a világ népszerű sportág | Article Noun Article Noun Adjective Noun 
profi sportágnak nyilvánítják a kosárlabdát romániában | profi sportág nyilvánít a labda román | Noun Noun Verb Article Noun Noun 
a teniszben vannak játékok és játszmák | a tenisz anna játék N\A ma | Article Noun Noun Noun N\A Noun 
a fogócskát általában szeretik a gyerekek | a fogó általában szeret a gyerek | Article Noun Adverb Verb Article Noun 
volt már pókerben royal flush-öd | volt mar póker l l | Adjective Verb Noun Noun Noun 
a snooker az egyik kedvenc játékom | a snooker az N\A kedvenc játék | Article Noun Article N\A Noun Noun 
sok pénzt vesztett a kockajátékokon | ok pénz veszt a kockajáték | Noun Noun Verb Article Noun 
minden tréfában részt vett | mind ban rész vet | Number Noun Noun Verb 
ez jó mulatság férfimunka volt | ez jó mulatság munka volt | Pronoun Adjective Noun Noun Adjective 
esztelenség amit ezek művelnek | esztelenség m N\A művel | Noun Noun N\A Verb 
hagyd már abba a bolondozást | hagy mar N\A a bolondozás | Verb Verb N\A Article Noun 
a kezdetben komoly tárgyalás viccelődésbe torkollott | a kezdetben komoly tárgyalás viccelődés ott | Article Adverb Adjective Noun Noun Adverb 
a közjáték alatt kiment a büfébe | a közjáték l ki a büfé | Article Noun Noun Adverb Article Noun 
táncot lejtett | tánc lejt | Noun Verb 
tánclépésben haladt a párja felé | tánclépés halad a pár fel | Noun Verb Article Noun Adverb 
harsogó énekléssel kísérték útjukat | harsogó éneklés kísér út | Adjective Noun Verb Noun 
mire föl az a nagy cécó | m föl az a nagy cécó | Noun Adverb Article Article Adjective Noun 
sietségében otthon hagyta a könyvét | sietség otthon hagy a könyv | Noun Noun Verb Article Noun 
ügyes manővereket hajtott végre vezetés közben | gyes manőver hajt végre vezetés köz | Noun Noun Verb Adverb Noun Noun 
megtanulta mind a négyféle úszótempót | megtanul mind a fel úszótempó | Verb Number Article Adverb Noun 
pillangóúszásban nyert | pillangóúszás nyer | Noun Verb 
a mellúszás a harmadik elem vegyesúszásban | a mellúszás a harmad elem vegyes | Article Noun Article Noun Noun Adjective 
a hátúszás a második elem vegyesúszásban | a hátúszás a második elem vegyes | Article Noun Article Noun Noun Adjective 
rettenetes pusztításba kezdett maga körül | rettenetes pusztítás kezdet mag örül | Adjective Noun Noun Noun Verb 
mi a foglalkozása | mi a foglalkozás | Pronoun Article Noun 
ez nincs kapcsolatban a munkájával | ez N\A kapcsolat a munka | Pronoun N\A Noun Article Noun 
a képességeinek megfelelő szakmát tanulta ki | a képesség megfelelő szakma tanult ki | Article Noun Adjective Noun Adjective Adverb 
szakterülete az ókori egyiptom művészete | szakterület az ókori m művészet | Noun Article Adjective Noun Noun 
30 évi szolgálat után visszavonult | 30 évi szolgálat tan visszavonult | Number Adjective Noun Noun Adjective 
fürdési lehetőséget természetesen biztosítunk vendégeink számára | fürdés lehetőség természetesen biztosít vendég szám | Noun Noun Adverb Verb Noun Noun 
elégedett az új állásával | elégedett az új állás | Adjective Article Adjective Noun 
a külügyminisztériumban van alkalmazásban | a minisztérium van alkalmazás | Article Noun Verb Noun 
a szobafestés jól jövedelmező foglalkozás | a szobafestés jól jövedelmező foglalkozás | Article Noun Adverb Adjective Noun 
jogot tanul szegeden | jog tanul szeg | Noun Verb Noun 
az orvostudományt sokan nagyon nehéznek tartják | az orvostudomány ok nagyon nehéz tart | Article Noun Noun Adverb Adjective Verb 
ezt a dokumentumot kézírással kell kitölteni | N\A a dokumentum kézírás kell kitölt | N\A Article Noun Noun Verb Verb 
a feladat megoldása nagy erőfeszítést igényelt | a feladat megoldás nagy erőfeszítés igényel | Article Noun Noun Adjective Noun Verb 
a küzdelem a kivitelezőkkel kimerítette | a küzdelem a kivitelez kimerített | Article Noun Article Verb Adjective 
az orvos rendszeres testedzést javasolt | az orvos rendszeres testedzés javasol | Article